00006000000000000000000000000000
00006000000000000000000000000000
00006000000050000000000050000005
3i113000031111300000031113100013
30001111110000311111130003000003
30000000000000300000030003000003
30000000000000300000030003005003
35070000000000000000030001111103
3i111000000000000011131000000003
30221100000000000110000000311103
30221110000000001100000000300003
30221111000000011000000031300011
30221111100000110000050030000000
30221111111111100001110030000000
30221111111111100000000030000705
30220000111011100000000030000111
30220050110501100000070030000111
30223111111111113111111130000111
30003000000000003000000030000111
30003000000000003000000030000111
30003000000080000000000030000111
11111111111111111111111111111111
99999999999999999999999999999999
