260000000000000000000000000000000062
260070007000000000000000000007007062
222222222222222263622222222222222222
000000000000000003000000000000000000
000000000000222203022220000000000000
000000000000555503055550000000000000
000000000022222203022222200000000000
000000000055555503055555500000000000
000000002222222203022222222000000000
000000005555555503055555555000000000
000000222222222203022222222220000000
000000555555555503055555555550000000
000022222222222203022222222222200000
000055555555555503055555555555500000
002222222222222203022222222222222000
005555555555555503055555555555555000
111111111111111103011111111111111114
000000000000000003800000000000000810
511111111111111111111111111111111115
999999999999999999999999999999999999