00000000003000000000000000000000
00000000003000000000000000000000
07050000003000000000000000005070
31117050003000000000000005071113
30001110003111163111130001110003
30000000000000033500030000000003
30000000000000053300030000000003
30000000000000033500030000000003
30000000000000053300030000000003
30000000000000033500000000000003
30000000000000053300000000000003
30000000000000033500000000000003
30000000000000053300000000000003
30000000000000033500000000000003
30000000000000053300000000000003
30000000000000033500000000000003
30000000000000053300000000000003
30000000000000033500000000000003
30000000000000053300000000000003
30000000000000033500000000000003
30000000000800003300000000000003
30000000031111111111111300000003
99999999999999999999999999999999
