001600000000000000000000000000006100
001600770000005505500000000077006100
001111111111111161111111111111111100
000000000000000060000000000000000000
000000000000000565000000000000000000
000000000000031161130000000000000000
000000000000030060030000000000000000
000000000005530060035500000000000000
000000000311111161111113000000000000
000000000300000060000003000000000000
000055000300000060000003000550000000
000011311111111161111111113111000000
000000300000000060000000003000000000
055000300005500060000000003005500000
011311111111111161111111111111111110
000300000000000060000000000000000000
000300000000000060000000000000000000
000300700000000860000000000000000700
111111111111111111111111111111111111
999999999999999999999999999999999999