00600000000000000000000000000000
00600000000000000000000444444444
00600000000000000000000300000003
00600000000000007000000300000003
11111310000001311100007300005003
00000300000000300000111311111111
00000300000000300000000300000000
00700300050000300000000300000000
11111311110000300000000300000000
00000300000000300000000300000000
00000300000000300000000300000000
00500300050000300000000300000000
11311111111111111300000300111103
00300000000000000300000300111103
00300000000000000300000300111103
00300000000000000300500300105103
00300500000000000344444300111113
11111111300000000000000300111113
00000000300000000000000300000003
00000000300000000000000300000003
00000000308000000000050300700003
11111111111111111111111111111111
99999999999999999999999999999999
