60000000000000000000000000000006
60000000000000000000000000000006
60057000000050000005000000075006
66611111111113000031111111111666
00000000000003000030000000000000
00000000000003000030000000000000
00000000311111111111111300000000
00000000300000500500000300000000
50007005300001111110000350070005
11111111305051000015050311111111
00000000301111000011110300000000
00000500300000055000000300500000
00031111111111111111111111113000
00030000000000000000000000003000
00030000000000080000000000003000
00030000000311111111300000003000
00030050005300000000350005003000
11111111111300000000311111111111
00000000000300000000300000000000
00000000000300000000300000000000
00050000000300000000300000005000
12121212121212121212121212121212
99999999999999999999999999999999
