00000000000000066000000000000000
00000000000000311300000000000000
00000000000000311300000000000000
00000000000075311357000000000000
00000000000031111113000000000000
00000000000031111113000000000000
00000000000531111113500000000000
00000000003111111111130000000000
00000000003111111111130000000000
00000000753111111111135700000000
00000000311111111111111300000000
00000000311111111111111300000000
00000005300055555555000350000000
00000031111111111111111113000000
00000031111111111111111113000000
00000531111111111111111113500000
00003111111111111111111111130000
00003111111111111111111111130000
00003000000000000000000000030000
00003000000000000000000000030000
00003000000000080000000000030000
11111111111111111111111111111111
99999999999999999999999999999999
