00050000000000000000000000000006
32212230000000000000000000000006
30000030000000000000000000000006
30000030000003111111111113000006
30507030000003000000000003058006
31212130000003000000000003111113
30000034440003000000000003000000
30000030000003000000000003000000
30000034444443444444400073000000
30000030000003000000311112222223
30000030000003000000300000000003
30000030000003005000300000000003
30007030500003111111300000000003
22111212211223000000000000000003
21112200000003000000000031111311
20002200000003000000000030000300
25002200000003000444444430000305
11111111131111222200000030001111
00000000030000000000000030000000
00000000030000000000000030000000
00000000030000000000000030000000
11111111111111111111111111111111
99999999999999999999999999999999