60000000000000000000000000000000
60000000000000000000000000000000
34444444444444000000000000000000
30000000000000105010000000000000
30000000300000111110000030000000
30005003330050000000500333005000
30003300300330000000330030033000
30003033333030000000303333303000
30003005750030003000300575003000
30000311111300033300031111130000
30000033333033003003303333300000
30000000000030333330300000000000
30000000000030057500300000000000
30000000000003111113000000000000
30000000000000333330000000000000
30005000000000000000000000005000
31111111300000000000000311111111
30000000300000000000000300000000
30000000300000000000000300000000
30000000300000000000000300000000
30000000300000000500800300000000
11111111111111111111111111111111
99999999999999999999999999999999
