00000000000006000060000000000000
00000000000006000060000000000000
00005070000316000061300007050000
31111111344316000061344311111113
31000001300016000061000310000013
31000001300016000061000310000013
31000001300016000061000310000013
31000001300016000061000310000013
31005001300016000061000310050013
31111111300016000061000311111113
31000001300016000061000310000013
31000001300016000061000310000013
31000001344413111131444310000013
31000001000313000031300010000013
31000001000313000031300010000013
31000001000313000031300010000013
31700001000313005731300010000713
31115111000312222221300011151113
30000000000300000000300000000003
30000000000300000000300000000003
30000000700300080000300000000003
11111111111111111111111111111111
99999999999999999999999999999999
