00000000000000000000006000000000
00005000000000000000006000000000
11111113111111111110006000000000
00000003444444444444446000050000
00000003000000001130001111111311
00000003000000001130000000000300
00000003000000001130000000000300
00000703000000001130000000570300
11311111000000001111111113111111
00300000000000000000000003000000
00300000000000000000000003000000
00300000000000000000000003000000
00300000000000007000000003000000
11111111111311111111111113000000
00000000000300000000000003000000
00000000000300000000000003000000
00000000000300000000000003000000
00000005000344444444444443005000
00003111111110000000000001111113
00003000000000000000000000000003
00003000000000080005000000000003
11111111111111111111111111111111
99999999999999999999999999999999