00060006000000000060000600000005
00430006000000007430000340000003
00034003700000004034000304000003
44030403400000040030400300400003
00030043040004400030045300040003
50030003004440000030004300004003
00030003000000040430000300000443
34430003000000004034444444404000
30000003000050040030000000030440
30044000000430400030040000030004
30000000004030000030004000030004
30000000540030000030000000430004
34400000400030000030000504030000
30007500000030000030000040030004
30044340000030000434000000030004
30000304000030004030400000030000
34400340400030040000040000030004
30000300040035400400004000030050
30044300404034000040000400030040
30000304000430000054000040030400
00000300000000000040400404434000
00000300005000000508000000030000
99999999999999999999999999999999
