00000000000000000000000000000000
00000000000000000000000000000000
00000000000000000000000000000000
00000000000000000000000000000000
00000000000000000000000000000000
00000000000000000000000000000000
00000000000000000000444440440000
00000000000000000031131101110000
00000000000000000030000000000000
00000000000000000034440000004440
00000000000000000030000000000000
00000000000000008030000000000000
11111111111111111111144111111111
00000000000000000000033111111111
00000000000000000000000000000000
00000000000000000000000000000000
00000000000000000000000000000000
00000000000000000000000000000000
00000000000000000000000000000000
00000000000000000000000000000000
00000000000000000000000000000000
00000000000000000000000000000000
99999999999999999999999999999999