                                    
                                    
                                    
            7          7            
i3i3i3i3i3i3i3i3i3i3i3i3i3i6        
i3i3i3i3i3i3i3i3i3i3i3i3i3i6        
5313 3135313 3135313 3135316        
i313i313i313i313i313i313i316        
i313i313i313i313i313i313i316        
i313i313i313i313i313i313i316        
 3135313 3135313 3135313 316        
i313i313i313i313i313i313i316        
i313i313i313i313i313i313i316        
53 3 3 3 3 3 3 3 3 3 3 3 316        
3111111111111111111111111116        
3         5 7 5   5 7      6        
3222222222222222222222222226        
35       8                56        
1111111111111111111111111111        
999999999999999999999999999999999999