                                    
                                    
                                    
1611111111111111111111111111        
16444444444444444444444444 1        
1612221222122212212312444131        
161    5    5   5  3   53131        
1653222222222222222222223231        
1613144444444444444442 53131        
16531 2222222222222222111131        
16131 2 555555555555   51531        
16531 2111222222122222311131        
16131     7           351531        
165312222222222211222231 231        
1613444444444444444444  3131        
1612211223221212232222223531        
16 7     3 22    3  7  53131        
1222121112222322121221122131        
 8           3            31        
999999999999999999999999999999999999