00000000000000000000000000000600
00000000000000000000000000000060
00000000000000000000000000000006
00000000000000000000008000000060
000i1111133111111133333000000600
00000000003000100030000000006000
00000000003000100030000000060000
00000000000303100030000000600000
00000500000033100030000006000000
00000150000003100030000060000000
00001115000003100030000006000000
00011111500003100030000000600000
00111111150003100030000000060000
11111111110003100030000000006000
05111111100003100030000000000600
00011111000003100030000000000060
00001110000003100030000000000006
00000100000003100030000000000006
00000000700003100030000700000006
031111111111111111i1111111111006
01111111111111111100000000003106
11111111111111111100055555553111
99999999999999999999999999999999
