                                    
                                    
                                    
   8   7   7   7   7   7   6        
11131i1311131i1311131i131113        
11131i1311131i1311131i131113        
11131i1311131i1311131i131113        
3333333333333333333333333333        
11131i1 1i13111 1i131i1 1113        
11131i1 1i13111 1i131i1 1113        
11131i151i1311151i131i151113        
3333333333333333333333333333        
1i1 11131i1 11131i1 11131i13        
1i1 11131i1 11131i1 11131i13        
1i1511131i1511131i1511131i13        
3533353335333533353335333533        
1113111311131113111311131113        
1113111311131113111311131113        
1113111311131113111311131113        
999999999999999999999999999999999999