6              1111111111111
6  5     5     1111111111111
111111111111113  5          
1111111111111111111111111113
     5 7   7 5             3
3111111111111111111111111111
3        5          5       
1111111111111111111111111113
    5        5      5      3
3111111111111111111111111111
3   5  7 7  7     5         
1111111111111111111111111113
   5      5      5      5  3
3111111111111111111111111111
3     5           5  8      
1111111111111111111111111111
9999999999999999999999999999