00000000050000050000000000000006
55511111111111111111111300000006
11100000000000000000000300000006
00000000000000050005000300000006
00000000000311111111111305000506
00000000000300000000000311111116
00000000000300000000000000000006
00005007050300000000000000000006
00031111111134444444400000050006
00030000000030000000031111111113
00030000000030000000030000000003
00030000000030000000030000000003
05030000000030000000030000005003
11130000007030007050030000311111
00000003111131111111130000300000
00000003444444444440000500300000
00000003000000000003111111300000
00000503500000000003000000300050
11111111300000000003000000311111
00000000300000000003000000000000
00000000300000000003000000000000
00000000300000500803000000500000
99999999999999999999999999999999
