                                    
                                    
                                    
111111111111111111111     61        
1 811444 22   5           61        
1 12  5 32211111133 313 3 61        
1 1     3    221 3353 3 3 61        
1 1311112115   1 33 3 313 61        
1 131      211   33 3 3 3 61        
15 31   5  121 31 3 3 3 3 61        
113311i1211121 3151611313 61        
113      7     31i161 3 3 61        
11311211111112333 161 3 3 61        
113 121111111233  161 3 3731        
1 3  2  5    23   1613311131        
1 3312111111123 5 16137   31        
1 1312111111123222161111  31        
1 131     5  221   6   1  31        
1 53 12222222221 7 6   11111        
999999999999999999999999999999999999