                     777    
                  5555556   
           55555561111111   
    55555562222222          
   61111111                 
   66                       
    6                       
55556                       
11113                       
11111111113                 
1111111111111113            
11111111111111111113        
11111111111111111111113     
1111111111111111111111113   
11111111111111111111111113  
111111111111111111111111138 
9999999999999999999999999999