622222866662262000272666667666526667
333333323233232222232222322222223222
223222323223233333232323323333333253
533232323323332222232323223222222223
223232323223232333232323323233333323
233332323323233323333333323222232323
222222322223232222232222333333332333
333333323333233333232333323222232222
222222323232232233333323323233233333
523332323222333223222223223232232223
323232323332323323233333333232332323
322232322232322333232322223232322323
323332333333332323332223223232323323
322232322222232323233323333333322323
323333333233332323222323222232222323
333232223222232323332323223233333322
323232333333332333222323333332322335
223232222222222322233322322222322222
253233333523333323332223333352333335
999999999999999999999999999999999999