00000000000000000000000000000000
00000000000000000000000000000000
00000000000000000000000000800000
00000000000000000000000000000000
00000000000000000000030000000000
00000000000000000000034444440000
00000000000000000000030440303000
00000000000000000000030040303000
00000000000000000000034440333004
00000000000000000000030000000343
00000000000000000004430040000003
00000000000000000000030000000003
11111111111441104010111111444111
11111111111111111111111111133111
11111111111111111111111111111111
00000000000000000000000000000000
00000000000000000000000000000000
00000000000000000000000000000000
00000000000000000000000000000000
00000000000000000000000000000000
00000000000000000000000000000000
00000000000000000000000000000000
99999999999999999999999999999999