000000000070000000000000000000700006
000000007000430003044300030000000006
000000000701003035350030300000000006
00i111112112000353535003030000000026
iiiiiiiiiiiii00053503500300002200206
000400003000000035300300000043451006
0010000350000000034032i2000305510006
001000000444444034000000003111110006
111111100000000340000002222222222226
111111111111110430010000000000000006
5111111000000000430111i1111110000006
222222220111111114300000000000000006
000000043000000000430000000031000056
000000500000000000043000031111111116
000000050111110000004300031111100556
000000000000004400003402222222222222
111111111111300500030000000000000000
251111111111300080300000000000000000
111111111111111111111111111111111111
999999999999999999999999999999999999