003050000000000000000000000600000000
003050000000000000000000000600000000
122122122221311111120000000600000000
000000000000344444444444444600000000
000000000000300000113000000650000000
000000000000300000113001111111113111
000000000000300300113000000000003000
000000000000300000113000000005003000
111311111111100000111111111131111111
000300000000000000010030010030000000
000300000000000000010030010030000000
000300000000000000010030010030000000
111111111111111311111111111130000000
000000000000000300000000070030000000
000000000000000300000000070030000000
000000000003050344444444404430005000
000000311111111110000000000011111133
000000300000000000000000000000000033
000000300007000008000300508000000033
111111111171111111111111111111111111
999999999999999999999999999999999999