  3   7    4   743    34   5
 43   434   4  4 34   3 4  3
4 3  4 3 4    4  3 4  3  4 3
5 3 4  3  4  4   3  453   43
  34  43   44    35  43    3
34   4 34  44  4 3444444 4  
3 4   43  45 4   3  4   3 4 
34 4   35443  4  3     43  4
3 4 4  344 3   4 3    4 3  4
34 5 4734  3 4  434  4  3  4
3 43  4    3   4   4    3  4
34 3   4   3  4 4   4   3  4
3 43 4  4  354   4   4  3 54
34 3   4 4 34 4  54   4 3 4 
3 43  4   43     4 4 4 434  
   3     5     58       3   
9999999999999999999999999999