                                    
                                    
                                    
57    22    656   7      8 5        
3444442424444344442244444443        
3444452442444344442424444443        
3444222444444344452442444443        
3444222444444344222444444443        
3444444444444344222444444443        
37   555     7            73        
3            5         55  3        
3444444444444344444444422443        
3444444442244344444444424243        
3444444442424344444444524423        
3444444452442344444442224443        
3444444222444444444442224443        
3      222        555      3        
3                          3        
3555555555555555555555555553        
999999999999999999999999999999999999