    444444              4   
 111      344   7  31111    
 15      344 11111131111    
 111     44  i1111i31551    
     111i    i1111i31111    
     111i 114i1551i3    i111
     155i 11 i1111i3    i111
     111i          3    i551
                   3    i111
         i11i      3        
i111i    i55i      3i111    
i111i    i11i      3i111 11 
i 5 i              3i551 11 
i111i              3i111    
              7    3 8      
1111111111111111111111111111
9999999999999999999999999999