00000000000000000000000000000000
34444444444444444444444444444444
31070000100000000000000010000001
30111111000000000000000001111110
30111111000000000000000001111110
30101111000000000000000001511110
30111111007000070000000701111110
30111101i11111111111111111111010
30111111i10001110001111111111310
30111111i10051110051111111111310
30111111i11111111111111111111310
30111111i11111111111111111111310
30111111i11111111111111111111310
30111111i11100000001111111111310
30111111i11100000001111111111310
30111111i11100000001111111111310
30111111i11100000001111111111310
30111111i11100000001111111111310
30111111i11100000053111111111310
30000000000011111113444444444300
30000000000222220000000000000000
30000008002222200000000700000000
99999999999999999999999999999999
