00000000000000000000000000000006
00022222222000000000000000006220
00200000000200000000000000060220
02000550700013000000000000600220
22113111111122300000000006000220
22113111111111130000700006005220
22113111111111113112222213222222
21113114444444133314444443444443
21133310000000130310000003000003
21130310000000130310050000005003
21130310050000130310000000000003
21130310080000130312200000000223
21135311113111135312200000000223
21111111113111111111111111111113
20000001133311105000005000050003
24444441330334444444444444444443
20000001300030000000000000000003
20500001300030000000000000000003
20000000300030000000000000007003
20000000300030001111111111111003
22220000300030111100510005011113
21111112350530001111111111111111
99999999999999999999999999999999
