                                    
                                    
                                    
              7  5                  
         5  11111131 5              
     111i1111     311111i1          
     1      1     31     1          
     1 75   1     31     1          
 11111111 5 15  1311111551          
 1      111i111113    1i1111        
 1      1     5 13 75    4 1        
 1      1    311111111111 31        
 1   5 51    31         5 31        
 1  11111    31 5  313 31111        
 1111   1 5131111  3111i1           
    1 5 11113   1 531               
    11111  13   111i1               
            3      8                
2121212121212121212121212121        
999999999999999999999999999999999999