00000000000000000000000066000000
00000000000000000000000330000000
00000000000000000000003300000000
00000000000000000000033000000000
00000000000000000000330000000000
00000000000000000003300000000000
00000000000000000033000000000000
00000000000000000330000000000000
00000000000000003307000000000000
00000000000000311111130000000000
00000000000000310000130000000000
55000000000000310000130000000000
11300000000000310550130000000000
01300000000003111111113000000000
00130070315031111111111130500000
00013311111111100133313011111130
00001303510333307030003000351130
00000130000030011130113000300130
00000013111031110130031300311130
00000001351031005113105130315130
00000000111111111111111111111138
22222222222222222222222222222222
99999999999999999999999999999999
