00000000000000000000000000600000
00000050000005000000000000600000
31111111111111111111300000600000
30000000000000000000344444600005
30000000000000050000300000311111
11111111113111111111100000300000
11111111133000000000000000300000
11111111334444443000000000300000
11111113300000003000000000300000
15051133000000703000500070300005
11111330000031111222211111311111
00000300000030000000000000300000
00000300000030000000000000300000
00000300000030000000000000300000
00000300000030000000000000300000
00007300050034444444444444300005
31111111111130005000050000311111
30000000000030011111111000300000
30000000000030000000000000300000
30000000000030000000000000300000
30000005000030000800050000300000
11111111111111111111111111111111
99999999999999999999999999999999
