00000000000000000000000000000006
44444444444400000500008000000006
30000000000311111111111113000006
30000000000300000000000003000006
30500000000300000000000003222222
11111130000300000000000003000000
00000030070300000005000003000000
00000031111113111111131111000000
00000030000003000000030000440000
00000030000003000000030000004400
00050030000003000700030000000044
11111310003111111131110000000000
00000300003000000030000000000005
00000344443000000030070000000001
00000300000003111111111130000000
00000300000003111111111130000000
00000300000003111111111130000000
11113111111111100000500111111131
11113111111111103111130111111131
00003000000000003111130000000030
00003000000800003111130000500030
11111111111111111111111111111111
99999999999999999999999999999999