000000000000000000000000000000000000
000000000000000000000000000000000000
000000000000000000000000000000000000
000000000000000000000000000067770000
000000000000000000000000000000777000
000000000000000000000000000600000010
000000000000000000311111111111111110
000000000000000000300000000000000000
000000000000000200300000000000000200
000000000000000222222222222222222200
000000000000080000000000000000000000
333333333333333333333333333333333333
333333333333333333333333333333333333
333333333333333333333333333333333333
333333333333333333333333333333333333
333333333333333333333333333333333333
333333333333333333333333333333333333
333333333333333333333333333333333333
333333333333333333333333333333333333
999999999999999999999999999999999999