262222222222222222222222222262222222
265555660000003322222222222260000002
211111066000033000000000000061212002
200000006600330000000005562122000002
200000400463300500006222221000000002
200000000033005500006000000000000502
200000000003300500061111111111111102
200000004000330000060007500000002002
200000000500033611111112222222222002
200000000550003300000000000000000002
200000000555000330000000000000007502
255555700555500033000011111111111112
211111101iiii00330000000000000000002
200000000000003300500000000000075002
200000550000033005500000000011111112
200000050000330055500000000000030002
200000000003300555500000000000300002
200000000033008000000000000003000002
111111111111111111111111111111151111
999999999999999999999999999999999999