00000000000000007500006000000000
00000000000000111111113000000000
00000000000000000000003000070500
00000000700500000000003131111113
00000051111113000000003030000003
1111i111000003444444443030000003
00000000000003000000003035000003
00000000000003000000003011111111
00000000000003000000003000000000
05000000000003000000003000000000
11113111111113000000003444444444
00003000000003000000003000000000
50003000070003000500003000000005
11111111111001111111113000111111
00000000000000000000003000000000
00000000500050000000003000000000
1111113111i111130050003000005000
00000030000000011111111111111113
00000030000000000000000000000003
00000030000000000000000000000003
00000030005008000000050000000003
11111111111111111111111111111111
99999999999999999999999999999999
