262222222222222222222222222202222222
230006660000003300000000000000000002
211130066000033000000000000001212002
200030006600330000000005502122000002
200030000663300000000222221000000002
200030000033000000000000000000000502
200000000003300000001111111111111112
200000000000330000000007500000000002
200000000000033011111111111111111002
200000000000003300000000000000000002
200000000000000330000000000000007502
205700000000000033000001111111111112
211111110000000330000000000000000002
200000000000003300000000000000075002
200000000000033000000000000011111112
200000000000330000000000000000000002
200000000003300000000000000000000002
200000000033008000000000000000000002
111111111111111111111111111111111111
999999999999999999999999999999999999