3 4 7  7  7  7   4  4  4 843
31 11511511511511 11 11 11 3
311 11 11 11 11 11 11 11 113
3 11 11 11 11 11 11 11 11 13
31 11 11 11 11 11 11 11 11 3
311 11 11 11 11 11 11 11 113
3 11 11 11 11 11 11 11 11 13
31 11 11 11 11 11 11 11 11 3
311 11 11 11 11 11 11 11 113
3 11 11 11 11 11 11 11 11 13
31 11 11 11 11 11 11 11 11 3
311 11 11 11 11 11 11 11 113
3 11511511511511511511511513
31 11 11 11 11 11 11 11 11 3
3                          3
1111111111111111111111111111
9999999999999999999999999999