                                    
                                    
                                    
5554444555 55544444444444555        
111    1113111           111        
111    1113111           111        
111    1113111    555    111        
111    1113111    111    111        
111    1113111    111    111        
111    1113111    111    111        
111    1113111    111    111        
111    1113111    111    111        
1115445111311154451115445111        
1111551111311115511111551111        
1111111111311111111111111111        
 11111111 3 1111111 1111111         
  111111  3  11111   11111          
   7     83          7              
1111111111111111111111111111        
999999999999999999999999999999999999