                                    
                                    
                                    
     6                              
     6           22222222222        
22222622222344443          2        
2    6     3 8  3   7      2        
1111131111111111111111111111        
113  3  3111    1111      11        
133111113111 11 111111111111        
13111111 311 51 111 11  11 1        
131 111 1311 11 111 5111 5 1        
1311 5 11311    111 11 511 1        
1311111113111111111i11111111        
13  1 15 33              731        
131111111 311111111311111131        
13 5111   3      113      31        
13      7 3   5  113   5  31        
1111111111111111111111111111        
999999999999999999999999999999999999