                                    
                                    
                                    
3444444444444444444444444443        
31 1  1 1     5  111 1 1   3        
3111  111   1 1  1 1 111   3        
3   5   5   111     5     83        
3 1 1  111       5 111  1 13        
3 111  1 15    111 1 1  1113        
35   5    1 1  1 1    7    3        
31 1 1 1  111       5 1 1  3        
3111 111      5   1 1 111  3        
3   5    5  1 1   111    5 3        
3 1 1   111 111  5     1 1 3        
3 111   1 1      1 1   111 3        
3    5     1 1   111   7   3        
3  1 1 1 1 1115 5     111  3        
3  111 111    1 1     1 1  3        
3 777 5       111   5     53        
999999999999999999999999999999999999