                                    
                                    
                                    
             6                      
             6                      
5            66            5        
13 3444444444464444444443 31        
1133 7                5 3311        
1113 3444444 4444444443 3111        
111133 5              331111        
1111i3 3444444 44444373i1111        
1111i133          5 331i1111        
1111i113 3444 44443 311i1111        
1111i11133 5      33111i1111        
1111i11113 344 43 31111i1111        
1111i1111133    3311111i1111        
1111i1111113    3111111i1111        
1111i111111138531111111i1111        
11117       3113        1111        
999999999999999999999999999999999999