22222222222222222222222222222261
34444444444444444444444444436661
30030000000110070000500000036501
30030011111111111111111111111131
30030011100000000000000000000031
30030000100000000000000500000031
30030003100111111111111111111111
30030003100050001050105010050001
30030003113111111111111111111111
30034443003111111111111111111111
30030003003111111011111111000001
30030003003000001011111111000001
30030003003444301000510000007001
30030003003000301111113441111111
30030003003000300000003001111111
30030003003000344443003001111111
30030003003000300003003001111111
30030003003000300003003001111111
30030003003000300003013111111111
30030003003000300003003111055501
30030803003000300003003111311111
11111111111111111111113055311111
99999999999999999999999999999999
