          5              6  
        31111111  5      6  
    5   3      111111    6  
11111111113         5    6  
          3111111611111311  
7         3      6     3    
11111111113      6 7   3   5
11111111113111111122   31111
11111111113            3    
11111111113       5 4443    
11      113       11   3    
11  55  113     5      3    
11111111111311111113   3    
           3       111111113
    5    8 3               3
1111111111111111111111111111
9999999999999999999999999999