003050000000000000000000000600000000
122122122221311111120000000600000000
000000000000344444444444444600000000
000000000000300000113000000650000000
000000000000300000113001111111113111
000000000000300300113000000000003000
000000000000300000113000000005003000
111311111111100000111111111131111111
000300000000000000000000000030000000
000300000000000000000000000030000000
000300000000000000000000000030000000
111111111111111311111111111130000000
000000000000000300000000000030000000
000000000000000300000000000030000000
000000000003050344444444444430038500
000000311111111110000000000011111113
000000300000000000000000000000000003
000700300000000000003005000003700003
111111111111111111111111111111111111
999999999999999999999999999999999999