007050000000000000000000000600000000
122122122221311111120000000600000000
000000000000344444444444444600000000
000000000000300000113000000650000000
000000000000300000113001111111113111
000000000000300700113000000000003000
000000007000300000113000000005703000
111311111111100000111111111311111111
000300000000000000000000000300000000
000300000000000000000000000300000000
000300000000000000000000000300000000
111111111111111311111111111300000000
000000000000000300000000000300000000
000000000000000300000000000300000000
000000000007050344444444444300507000
000000311111111110000000000111111113
000000300000000000000000000000000003
000000300000000000080500000000000003
111111111111111111111111111111111111
999999999999999999999999999999999999