11111111111111111111161111111111
10000000000000000000061070500001
10500000000000000000061111111131
1i111131111130005000061111111131
1i111131111111111111111101110031
1i111131111111111111111101110031
10000030000000000001111101110031
10000030050700000001111101110031
13111111111131111111111101110031
13000111111131111111111101110031
13000111111131111111155111115031
13000111111131111111111111111131
13000100000530000005007000050131
13000111131111111113111111113131
13000111130000000003111111113131
13005100030000000003111111113131
1311i100030008000003000110003131
1311i131111131111111111115503131
1311i131111131111111115111111131
1311i131111130000000000000000031
13700031151130005000000070000031
11111111111111111111111111111111
99999999999999999999999999999999
