00000000000005000000000000000600
00000000031111111110050000000600
00000000030000000011111110000600
00005000030000000000000000000600
11111111111130000000000050000600
00000000000031111116111111311100
00000000000030000006000000300000
00000000000030000006000000300000
70000000000030000006000000300000
11111111111130000006070000300005
11111111111131111111220000311111
11111111111130000000000000300000
11111111111130000000000000300000
11111111111130000000504444300000
11000000001130000000110000300000
11000000001130000000000000300000
11005050001130000050000000300000
11111111111113111111130000300000
00000000000003000000011111111113
00000000000003000000000000000003
00000500008003000000000000000003
11111111111111111111111111111111
99999999999999999999999999999999
