1111111111111161111111111111
1    7 5 7  8666  7 5 7    1
1611111111111   111111111161
 34444444444444444444444443 
 3           6            3 
 3           6            3 
 3           6            3 
 3           6            3 
 3           6            3 
 3           6            3 
 3           6            3 
 3           65           3 
 3     5      2      5    3 
 3     2      2      2    3 
3      2      2      2  7  3
311111   1111 2 1111   11113
9999999999999999999999999999