600000444444444444444444444444444444
600000000iii0000000iii00000000000003
600iii000i5i0000000i5i00070000iii003
600i5i000111000000011100000070i5i003
6001110004340iii00043400000000111003
6004340000300i5i00003000iii000434003
600030000030011100003070i5i00003iii3
60003000iii004340000300011100003i5i3
60003000i5i0003000003000434000031113
666030001110003iii003000030000034343
iii030004340003i5i003000030iii030303
i5i030000300003111003000030i5i030303
11103070030iii3434003000030111030303
43403000030i5i3030003iii030434030303
030030iii301113030003i5i03003003iii3
030030i5i30434303000311103003003i5i3
030030111300303030003434030030031113
030030434300303030803030030030034343
111111111111111111111111111111111111
999999999999999999999999999999999999