                                    
                                    
                                    
1111111334444444444331111111        
11111133   4    4   33111111        
1111133     1771     3311111        
111133    4 1111 4    331111        
11133    4 111111 4    33111        
113344444 11111111 444443311        
133    4 1111551111 4    331        
33      111111111111      33        
133    4 1111551111 4    331        
1133    4 11111111 4    3311        
11133    4 111111 4    33111        
111133    4 1111 4    331111        
1111133    4    4    3311111        
11111133            33111111        
1111111337   8    7331111111        
1111111111111111111111111111        
999999999999999999999999999999999999