                                    
                                    
                                    
                                    
          77 66 77                  
         5556116555                 
   5555562222222222655555           
  6111111          1111116          
  666                  666          
    6                  6            
    6                  6            
    6                  6            
    6                  6            
    6                  6            
    6                  6            
    6                  6            
    6                  6            
    6          8       6            
2111111211111221111121111112        
999999999999999999999999999999999999