00000000000000000000000060000000
00060500000000000000000060000000
12212212221311111120000060000000
00000000000344444444444460000000
00005000000300001130000060000000
00003500000300601130000065000000
05703002820300001130001111131111
22222122220300001130000000030000
00000000000300001130000000030000
00000000000300001130000000530000
11131111111100001111111131111111
00030000000000000000000030000000
00030000000000000000000030000000
00030000000000000000000030000000
11111111111111311111111130000000
00000000000000300000000030000000
00000000000000300000000030000000
00000000006050344444444430050600
00000031111111110000000011111113
00000030000000000000000000000003
00000030000000000060050000000003
11111111111111111111111111111111
99999999999999999999999999999999