                                    
                                    
                                    
1111111111111111116111111111        
1 5               61 7 5   1        
1i111311113   5   6111111131        
1i111311111111111111 111  31        
1    3  5 7     1111 111  31        
13111111111311111111 111  31        
13   111111311111551 1115 31        
13   11111131111111111111131        
13   1    53    5  7   5 131        
13   11131111111311111113131        
13  51113       311111113131        
1311i1  3    8  3  11   3131        
1311i131111131111111155 3131        
1311i13111113111111511111131        
137   3115113    5  7     31        
1111111111111111111111111111        
999999999999999999999999999999999999