00000000000000000000000060000000
00060000000000000000000060000000
12212212221311111120000060000000
00000000000344444444444460000000
00000000000300001130000060000000
00000000000300601130000060000000
00000000000300001130001111131111
00000000000300001130000000030000
00000000000300001130000000030000
00000000000300001130000000030000
11131111111100001111111131111111
00030000000000000000000030000070
00030000000000000000000030800800
00030000500000000000000030000101
11111111111111311111111130000173
00000000000000300000000030000003
00000000000000300000000030000101
00000000006000344444444430000101
00000031111111110000000011111113
00000030000000000000000000000003
00000030000000000060000000000003
11111111111111111111111111111111
99999999999999999999999999999999