4444444444444344444444444444
 5      5    3   5   5 75  5
75  5    7 5 3 5   5 5      
 1i11i13 31i11113 31i1      
 1i11i11331i1111i331i1      
 1i11i11i31i1111i131i1      
 1i1  11i31i1  1i131i1      
 1i1  11i31i1  1i131i1      
 1i1  11i31i1  1i131i1      
 1i1  11i31i1  1i131i1      
 1i1 511i31i1 51i131i1      
 1i1i111i31i1i11i131i111i11 
 1i1i111 31i1i11i 31i111i11 
 1i1i11  31i1i11  31i111i11 
         3   8    3         
1111111111111111111111111111
9999999999999999999999999999