111111111111111111          
1               1 1         
131111131111111111 111111 11
13     34441   14   3       
1311   77    311   33     3 
13             111 131111111
13    8             3     31
11111 1111111    1  31111131
  3             1  14     31
 1113111111111111  1   1  31
111131111111111111   111  3 
1   111113 1 131111111111111
131111   3 1 13   1133 3  33
131111111131113 113133 3 13 
13       131  11113113   131
1111111111111111111113113 31
9999999999999999999999999999