                                    
                                    
                                    
1111133333333333333333111111        
111133               3311111        
11133     8      7    331111        
1133  311111131111113  33111        
113   31  5 131 5  13   3111        
113444325   131   5234443111        
113555311 1113111 1135553111        
1135553 1 i222221 1 35553111        
113   3 111     111 3   3111        
1134443     555     34443111        
113   3 11111111111 3   3111        
1137      5333335     731111        
1113    ii1iiiii1ii   311111        
111137              73111111        
111113              31111111        
1111113555555555555311111111        
999999999999999999999999999999999999