4444444444444354444444444444
 5 575       53       585 5 
11111111     35     11111111
11     11    53    11     11
161    1 1   35   1 1    161
1661   1  1  53  1  1   1661
166617 1   1 35 1   1 716661
16666ii111i115311i111ii66661
16666i 1    1351    1 i66661
11111i115   1531   511i11111
 1333i3315  1351  5133i3331 
  133i33315 1531 51333i331  
3  13i3333i513515i3333i31  3
33  1i33333i1531i33333i1  33
  3  ii1111i1351i1111ii  3  
1133         53         3311
9999999999999999999999999999