                                    
                                    
                                    
            3113                    
          75311357                  
          31111113                  
         5311111135                 
        311111111113                
      7531111111111357              
      3111111111111113              
     53   55555555   35             
    31111111111111111113            
   5311111111111111111135           
  311111111111111111111113          
  311111111111111111111113          
  3                      3          
  3                      3          
  3          8           3          
1111111111111111111111111111        
999999999999999999999999999999999999