00000000000000300000000000000000
00000000000000308000000000000000
00000000000000311000000000000000
00000000000000300000000000000000
00000000000000300000000000000000
00000000000000344444440000000000
00000000033333303100000000000000
00000000030000000044440000000000
00000000030000000000333330030000
00444444430000000000030300344003
00000000003000300000303000030003
11144124131111311111111111111111
11111113131111311111111111111111
00000000030000300000000000000000
00000000000000000000000000000000
11111111111111111111111111111111
00000000000000000000000000000000
00000000000000000000000000000000
00000000000000000000000000000000
00000000000000000000000000000000
00000000000000000000000000000000
00000000000000000000000000000000
99999999999999999999999999999999