00000000000000000000000000000000
00000000000000700000070000000006
i3i3i3i3i3i3i3i3i3i3i3i3i3i3i3i6
i3i3i3i3i3i3i3i3i3i3i3i3i3i3i3i6
i3i3i3i3i3i3i3i3i3i3i3i3i3i3i3i6
53130313531303135313031353130316
i313i313i313i313i313i313i313i316
i313i313i313i313i313i313i313i316
i313i313i313i313i313i313i313i316
i313i313i313i313i313i313i313i316
03135313031353130313531303135316
i313i313i313i313i313i313i313i316
i313i313i313i313i313i313i313i316
03030303030303030303030303030316
53030303030303030303030303030316
31111111111111111111111111111116
30000000000000000000000000000006
30000050007000500000500070000006
32222222222222222222222222222226
30000000000000000000000000000006
35000000000800000000000000000056
11111111111111111111111111111111
99999999999999999999999999999999
