1111111111111               
18 1  1 5   1 3   4444444444
1  15   31 5143   3         
111113111111173  63 1111111 
1  1531  15 1 3 6 3 5111511 
15 1 315    1436  3 1511115 
11 1131111111     3 5111511 
1 51 31 513 1     3 1511115 
1   531  15 1     3 5111511 
1111131111111     3 1511115 
1441 31441  1     3         
1441 31441 71     3111111111
1111111111111     31  31  51
13 1     1        3111111111
137   1 5  31     31   13 51
1111111111111111111111111111
9999999999999999999999999999