         6        6         
         6        6         
    1    6        6    1    
    122i131i2222i131i221    
    155i131i    i131i551    
    111 231 1111 132 111    
       22322    22322       
   122i2332      2332i221   
   155i23112i22i21132i551   
   111 23155i22i55132 111   
      223111 22 111322      
  122i233   2222   332i221  
  155i23            32i551  
  111 23            32 111  
  77 233  8       77332 7   
11113 3111111111111113 31111
9999999999999999999999999999