                                    
                                    
                                    
16                         1        
1644444444444444444444444441        
16       i1113111i         1        
16    5i1i   3   i11 5     1        
16  5i1i555553557551i1 5   1        
16 11i1i111113111111i1i1 5 1        
1111         3         1i1i1        
11     5555  37 5555     1i1        
1    3111111i311111113     1        
1    3       3       3     1        
1   53  555553 5 55553 7   1        
1 3i1111111113i1111111113  1        
1 3          3          3  1        
1 3          3          3  1        
1 3          3  8       3  1        
1111111111111111111111111111        
999999999999999999999999999999999999