                                    
                                    
                                    
1111111111333333331111111111        
1111111333377   833331111111        
11111133   111111   33111111        
1111133 111114111111 3311111        
111133 111111441 1511 331111        
11133 1151111441111111 33111        
1113 11117   44   71111 3111        
1113 111111114411111111 3111        
1113 111114414414411111 3111        
1113 111144114411441111 3111        
11133 114 11 441115411 33111        
111133 111111 4111111 331111        
1111133 111111 11111 3311111        
11111133   111111   33111111        
11111113333      33331111111        
1111111111333333331111111111        
999999999999999999999999999999999999