60000000000000000000000000000006
60000000000000000000000000000006
60000000000000000000000000000006
60000000070000000000000000000006
3111i111111111111111111111111113
3111i111111111111111111111111113
3111i111111111111111111111111113
3111i111111111111111111111111113
30005000111444444444110000000003
30000000511300007005110000000003
30000000111301111111110000070003
30000000111300000000110011111113
30011100111300000000110011151113
30015100111111111133110011111113
30008000111111111133110011151113
30011100111111111133110011111113
30011100111000000030110000000003
30011100111000000030110000000003
30011100111000000530110000500003
11111111111311111111113111111111
11111111111311111111113111111111
11111110005311111105003111111111
99999999999999999999999999999999
