00000000000006000000000000000000
00000000000006000000000000000000
00000000000006000005000000070000
11111000000600000011113111111111
00011100000600000110003000000000
00001110000600001100003000000000
05701111000600511000003000000000
11131111100600111000003000000000
00030000110601111000003000005000
00030000011311111311113111111111
00030000000300000300000000000000
00030570000000000300000000000000
31111130000000000300000000000000
30000030000000000300000000500000
30000030000000001311113111100000
30000030000000000000003000000000
30000030000000000000003000000000
30000030000500000700003000000000
30000031111111311111113111111311
30000000000000300000000000000300
30000000000000300800000000000300
11111111111111111111111111111111
99999999999999999999999999999999
