11111111111111111111161111111111
10000000000000000000061070500001
10500000000000000000061111111131
10111131111130005000061111111131
10111131111111111111111101110031
10111131111111111111111101110031
10000030000000000001111101110031
10000030050700000001111101110031
13111111111131111111111101110031
13000111111131111111111101110031
13000111111131111111155111115031
13000111111131111111111111111131
13000100000530000005007000050131
13000111131111111113111111113131
13000111130000000003111111113131
13005100030000000003111111113131
13110100030008000003000110003131
13110131111131111111111115503131
13110131111131111111115111111131
13110131111130000000000000000031
13700031151130005000000070000031
11111111111111111111111111111111
99999999999999999999999999999999
