00000000000000000000000000000000
00000000000000000000000000000000
00000000000000000000000000000000
00000000000000003000000000000000
00000000000000003000000000000000
00000000044444400004444000000000
00000000001131103031111000000000
00000000000030003030000000000000
00000000033333333330000000000000
00000000000000000034444440000000
00000000000000000030000000000000
00000000000000800030000000000000
00000001111011111111111111000000
00000000000000000000000000000000
00000000000000000000000000000000
00000000000000000000000000000000
00000000000000000000000000000000
00000000000000000000000000000000
00000000000000000000000000000000
00000000000000000000000000000000
00000000000000000000000000000000
00000000000000000000000000000000
99999999999999999999999999999999
